NO ./textures/NO.xpm
SO ./textures/SO.xpm
WE ./textures/WE.xpm
EA ./textures/EA.xpm

F 80,80,80
C 30,30,30

111111111111111111111111111111111111111111111
11111111111111111111111111111111111111111111111111111111111111
100000000000011100000010000011000000000000011
100000000000000000000010000011000000000000011
100000000000011100000010000011000000000000011
11111100111111110000000000001100000000000001111
100000000000000000000000000011111111100111111
10000000000001110000W001000000000000000011111
100000000000011100000000000011100000111000011
100000000000011111111110000011100000000000011
100000000000011100000000000011000001111111111
100000000000000000000000000000000000000000111
100000000000000000000000000011000000000000011
111111111111111100000000000000000000000000011
100000001000000100000110000011100000000000011
100000001000000100000110000000000000000000011
100000001000000100000110000011111111110000011
100100000000000000000110000011100000000000011
100100000000000100000000000011100000000000011
111111111111111100000000000011100000000000011
100000000000000000111111100011000000000000011
100001111000000001000000000011000000000000011
100001000000000111000000000000000000000000011
100001000000000100000000000011100000000000011
111111111111111111111111111111111111111111111 

