NO ./textures/banner.xpm
SO ./textures/eagle.xpm
WE ./textures/hitler.xpm
EA ./textures/grey.xpm
F 10,100,0
C 225,30,0

1111111111111111111111111111111111111111111111111111
1111111111111111111111111111111111111111111111111111
1000000000000111000000000000111000000100000110000001
1000011100000111000000000000111000000100000000000001
1000001000000111000000000000111000000100000000000001
1000000000000111000000000000111000000000000110000001
1001111111001110000000000000000000000011111110000001
10000011111111100000E0000000111100000000111110000001
1000000000000111000000000000000000000000000110000001
1000000000000000000000000011111000000000000000000001
1000000000000000000000111000000000000000000000000001
1000000000000111000000000000000000000111100110000001
1111000000001111111111111111111111111111111111110111
1000000000000000000000111111111100000000000110000001
1000000000000000000000111000000000000000000110000001
1000000000000111000000000000000000000111100000000001
1111111111111111111100000111111111111111111111100111
1000000000000000000000000111111100000000000110000001
1000000000000000000000000000000000000000000110000001
1000000000000111000000000000000000000111100110000001
1111110000000000000000000111111111111111111111100111
1000000000000000000000000000000000000000000110000001
1000000000000000000000111000000000000000000000000001
1000000000000111000000000000000000000111100110000001
1111111111111111111111111111111111111111111111111111
