NO ./textures/brickbrown.xpm
SO ./textures/brickred.xpm
WE ./textures/brickblue.xpm
EA ./textures/brickpurple.xpm

F 80,80,80
C 30,30,30

111111111111111111111111111111111111111111111
111111111111111111111111111111111111111111111
100000000000011100000010000011000000000000011
10000000000000D000000010000011000000000000011
100000000000011100000010000011000000000000011
111111101111111100000000000011000000000000011
1000000000000D0000000000000011111111110111111
10000000000001110000N001000000000000000011111
100000000000011100000000000011100000111000011
1000000O0000011111111111111011100000000000011
100000000000011100000000000011000001111111111
1000000000000100000000000000D0000000000000111
1000000000000D0000000000000011000000000000011
1111011111111111000000000000D0000000000000011
100000001000000100000110000011100000000000011
1000000010000001000001100000D0000000000000011
100000001000000100000110000011111111110000011
100100000000000D00000110000011100000000000011
100100000000000100000000000011100000000000011
111111111111111100000000000011100000000000011
100000000000000111111111101111000000000000011
100001111000000001000000000011000000000000011
100001000000000111000000000000000000000000011
100001000000000100000000000011100000000000011
111111111111111111111111111111111111111111111 

