NO ./textures/brickbrown.xpm
SO ./textures/brickred.xpm
WE ./textures/brickblue.xpm
EA ./textures/brickpurple.xpm

F 80,80,80
C 30,30,30

111111111111111111111111111111111111111111111
111111111111111111111111111111111111111111111
100000000000011100000010000011000000000000011
10000000000000D000000010000011000000000000011
100000000000011100000010000011000000000000011
111111001111111100000000000011000000000000011
1000000000000D000000000000001111111111D111111
10000000000001110000W001000000000000000011111
100000000000011100000000000011100000111000011
100000000000011111111110000011100000000000011
100000000000011100000000000011000001111111111
1000000000000100000000000000D0000000000000111
1000000000000D0000000000000011000000000000011
1111111111111111000000000000D0000000000000011
100000001000000100000110000011100000000000011
1000000010000001000001100000D0000000000000011
100000001000000100000110000011111111110000011
100100000000000D00000110000011100000000000011
100100000000000100000000000011100000000000011
111111111111111100000000000011100000000000011
1000000000000000001111111D1111000000000000011
100001111000000001000000000011000000000000011
100001000000000111000000000000000000000000011
100001000000000100000000000011100000000000011
111111111111111111111111111111111111111111111 

