NO ./textures/vacio.xpm
SO ./textures/nazi3.xpm
WE ./textures/nazi2.xpm
EA ./textures/nazi1.xpm

F 100,100,100
C 200,200,200

111111111111111111111111111111111111111111111
10000000000000000N0000000000000000000000000001
101111111111111111111111111111111111111111101
101000000000000000000000000000000000000000101
101011111111111111111111111111111111111110101
100000000000000000000000000000000000000000001
111111111111111111111111111111111111111111111
100000000000000000000000000000000000000000001
101111111111111111111111111111111111111111101
100000000000000000000000000000000000000000001
111111111111111111111111111111111111111111111
100000000000000000000000000000000000000000001
101111111111111111111111111111111111111111101
100000000000000000000000000000000000000000001
111111111111111111111111111111111111111111111
100000000000000000000000000000000000000000001
101111111111111111111111111111111111111111101
100000000000000000000000000000000000000000001
111111111111111111111111111111111111111111111
100000000000000000000000000000000000000000001
101111111111111111111111111111111111111111101
100000000000000000000000000000000000000000001
111111111111111111111111111111111111111111111
