NO ./textures/banner.xpm
SO ./textures/eagle.xpm
WE ./textures/hitler.xpm
EA ./textures/grey.xpm

F 10,100,0
C 225,30,0

111111111111111111111111111111111111111111111
111111111111111111111111111111111111111111111
111100001011111100000000000011100000000000011
100000001111111100000000000011100000000000011
111100000000000000000S00000011111111110001011
100000000000011101110000000000000000000001011
111100000000000000000000000011111111110011011
100000000000011101110000000000000000000010011
111100000000000000000000000011111111111110011
100000000000011101110000000011111111111110011
111100000000000000000000000011111111110000011
100000000000011101110000000000000000000000011
100001100000111000000000011100000000001111111
111111111111111111111111111111111111111111111
