NO ./textures/banner.xpm
SO ./textures/brick.xpm
WE ./textures/hitler.xpm
EA ./textures/grey.xpm

F 10,100,0
C 0,30,0

11111111111111111111111111111
11111111111111111111111111111
10000000000001110001000000001
10000000000001110001000000001
10000N00000001110001000000001
10000000000000000000000000001
10000000000011100000000001111
11111111111111111111111111111
