NO ./textures/brickdirty.xpm
SO ./textures/nazi3.xpm
WE ./textures/nazi2.xpm
EA ./textures/nazi1.xpm

F 10,100,0
C 225,30,0

111111111111111111111111111111111111111111111
111111111111111111111111111111111111111111111
1111000000000000D0000000000001000000000000011
1000000011111111100000000000D0000000000000011
111100000000000010000S0000001111111111D111111
111111111D11111111110000000000000000000001011
111100000000000000000000000011111111110011011
100000000000011101110000000000000000000010011
111100000000010000010000000011111111111110011
1000000000000100000D0000000011111111111110011
111100000000010000010000000011111111110000011
100000000000011111110000000000000000000000011
100001100000111111110000011100000000001111111
111111111111111111111111111111111111111111111
