NO ./textures/brickdirty.xpm
SO ./textures/nazi3.xpm
WE ./textures/nazi2.xpm
EA ./textures/nazi1.xpm

F 100,20,10
C 225,30,0

		1111111111111111111111111
		1000000000110000000000001
		1011000001110000000000001
		1001000000000000000000011
111111111011000001110000000000001
100000000011000001110111111111111
11110111111111011100000010001
11110111111111011101010010001
11000000110100010000000010001
100000000D00000000000000D0001
10000000010000001101010010001
11000001110101011111011110N0111
11110111 1110101 101111010001
11111111 1111111 111111111111
11111111 1111111 111111111111














