NO ./path_to_the_north_texture
SO ./path_to_the_south_texture
WE ./path_to_the_west_texture
EA ./path_to_the_east_texture

F 10,100,0
C 225,30,0

11111111111111111111111111111111111111111
11111111111111111111111111111111111111111
10000000000001110000000011100000000000011
10000000000001110000000011100000000000011
10000000000001110000000011100000000000011
10000000000001110000000011100000000000011
10000000000011100000000000000000001111111
10000000000011100000000000000000000011111
100000000000011100000000N0000000000000011
10000000000001110000000000000000000000011
10000000000000000000000000000000000000011
10000000000001110000000000000000000000011
11111111111111111111111111111111111111111
