NO ./textures/wood.xpm
SO ./textures/brick.xpm
WE ./textures/hitler.xpm
EA ./textures/eagle.xpm

F 80,80,80
C 30,30,30

111111111111111111111111111111111111111111111
111111111111111111111111111111111111111111111
100000000000011100000000000011100000000000011
100000000000011100000000000011100000000000011
100000000000011100000000000011100000000000011
100000000000011100000000000011100000000000011
100000000000111000000000001100000000001111111
10000000000011100000W001001110000000000011111
100000000000011100000000000011100000000000011
100000000000011100001110000011100000000000011
100000000000011100000000000011100000000000011
100000000000011100000000000011100000000000011
111111111111111111111111111111111111111111111
111111111111111111111111111111111111111111111
111111111111111111111111111111111111111111111
111111111111111111111111111111111111111111111
