NO ./path_to_the_north_texture
SO ./path_to_the_south_texture
WE ./path_to_the_west_texture
EA ./path_to_the_east_texture

F 10,100,0
C 225,30,0

111111111111111111111111111111111111111111111
111111111111111111111111111111111111111111111
100000000000011100000000000011100000000000011
100001110000011100000000000011100000000000011
100000100000011100000000000011100000000000011
100000000000011100000000000011100000000000011
100111111100111000000000000000000000001111111
10000011111111100000E000000011110000000011111
100000000000011100000000000000000000000000011
100000000000000000000011111111110000000000011
100000000000000000000011100000000000000000011
100000000000011100000000000000000000011110011
111111111111111111111111111111111111111111111
