NO ./path_to_the_north_texture
SO ./path_to_the_south_texture
WE ./path_to_the_west_texture
EA ./path_to_the_east_texture

F 10,100,0
C 225,30,0

111111111111111111111111111111111111111111111
111111111111111111111111111111111111111111111
100000000000011100000000000011100000000000011
100000000000011100000000000011100000000000011
100000000000011100000000000011100000000000011
100000000000011100000000000011100000000000011
100000000000111000000000011100000000001111111
10000000000011100000N000001110000000000011111
100000000000011100000000000011100000000000011
100000000000011100000000000011100000000000011
100000000000011100000000000011100000000000011
100000000000011100000000000011100000000000011
111111111111111111111111111111111111111111111
111111111111111111111111111111111111111111111
111111111111111111111111111111111111111111111
111111111111111111111111111111111111111111111
